11111111111111
10010000000C01
10000111110001
1P00110E000001 
11111111111111
