1111111111111111111111111
1C0000C100C0000011000C0E1
1000C00110000000110C00001
1P0011111001C000110000001
100001110000000011000C001
1100001100000000000000001
11000000000C0000000000001
1110000C00000000000000001
11110000C00000001100000C1
1111111111111111111111111
