11111111111111
100C1000000C01
11111000000001
1P0000E0000001
11111111111111 


